11111 11111 11111
10000 00000 000h1
10222 22222 22201
10200 0hhh0 02201
10200 22222 22201

10200 00h00 0h201
10222 2202h 20201
10920 00h22 20000
10222 2202h 20201
10200 00h00 0h201

10202 22222 22201
10200 0hhh0 02201
10222 22222 22201
10000 00000 000h1
11111 11111 11111
a
