11111 11111 11111
10000 00500 00001
10000 00000 00001
10011 10Y01 11001
10000 01010 00001

10000 10001 00001
10000 10001 00001
10000 10001 00001
10000 10001 00001
10000 10001 00001

11111 00000 11111
10000 00000 00001
10000 00000 00001
10000 00000 00001
11111 11011 11111
8
