11111 11111 11111
10000 00000 000A1
10000 00000 00001
10033 01100 00001
1003A 10011 00001

10001 00000 10001
10010 0A0A0 01101
10010 00000 000W0
10001 00000 00001
10001 00000 00001

10000 10000 00201
10000 01000 00021
10000 01000 20001
1A000 00000 020A1
11111 11011 11111
8
