11111 11111 11111
10000 00000 00001
100C0 00000 0C001
10001 11111 10001
10000 00000 00001

10000 D3D3D 00001
10010 00000 01001
10012 00V00 21001
10010 00000 01001
10010 00000 01001

10000 10101 00001
10000 00000 00001
10000 00000 00001
10000 00000 00001
11111 11011 11111
8
