11111 11111 11111
10000 00a00 00001
100A0 00100 0A001
10000 00100 00001
10000 00100 00001

10000 00000 00001
10000 22230 11101
10000 00C33 A0100
10000 00033 A0101
10000 22230 11191

10000 00000 00001
10000 00000 00001
10000 00000 00001
10000 00000 00001
11111 11011 11111
8
