11111 11011 11111
10000 00000 00a01
10000 00000 01a01
11111 00001 01001
1000X 10001 00001

10000 10A01 02001
10000 10C01 02001
00010 00001 02201
10011 00001 00201
10000 00001 00201

10001 11001 00001
10000 C0001 00001
100A0 00001 00001
10000 00001 0AAA1
11111 11111 11111
8
