11111 11111 11111
10000 00000 00001
10C00 01210 00001
10002 00000 000C1
10200 00000 00101

10000 11111 00101
10100 000A1 001W1
10100 00201 00100
10100 00001 00101
10000 00001 00101

1001A 00000 00191
10011 00000 00001
10000 00000 00001
1A000 00000 00001
11111 11011 11111
8
