11111 11011 11111
10000 01010 00001
10000 01010 00001
10000 01010 00001
1000A 01010 A0001

10000 00000 00001
11111 01110 11111
00000 00100 000W0
11111 00100 11111
10000 00000 00001

1000A 00C00 A0001
10000 00000 00001
10000 02220 00001
10000 00A00 00001
11111 11111 11111
8
