11111 11111 11111
10000 00000 00AA1
10000 00000 A11A1
10000 00000 11A01
10000 00001 10001

10000 00C11 00001
10000 00110 00001
00000 011C0 00001
10000 11000 00001
10001 10000 00001

10011 00000 00001
10110 00000 00001
17100 00000 00001
17000 00000 00001
11111 11011 11111
8
