11111 11011 11111
10000 00000 00001
10110 00300 01101
10100 03330 00101
10000 33333 00001

10003 33333 30001
10203 33D33 30201
10A03 3D3D3 30A01
10203 33D33 30201
10003 33333 30001

10000 33333 00001
10100 03330 00101
10110 00300 01101
10000 00000 00001
11111 11011 11111
8
