11111 11111 11111
10000 00000 00001
10000 00100 00001
10022 00100 22001
10000 00100 00004

10000 0A0A0 000D4
10000 00100 00034
100C0 00100 00X33
10000 00100 00034
10000 00100 000D4

10000 00100 00004
10000 00100 00001
10011 00100 11001
10000 00000 00001
11111 11011 11111
8
