22222 22922 22222
10000 00000 00001
100A0 00100 00A01
100C0 00100 00C01
10000 00100 00001

10000 00100 00001
10000 00000 00001
10101 10201 10101
10000 00000 00001
10000 00100 00001

100A0 00100 00A01
100a0 00100 00a01
10000 00100 00001
10000 00000 00001
11111 11011 11111
1
