11111 11011 11111
10000 00000 00001
10000 02220 00001
10010 00A00 01001
40000 00000 00001

43002 11111 20001
43200 A333A 00201
33200 33533 00200
43210 00000 01201
43011 03030 11001

40000 03030 00001
10000 00C00 00001
10000 02220 00001
10000 00000 00001
11111 11011 11111
8
