11111 11111 11111
10000 00100 00001
10000 00100 00A01
10111 00100 00001
10001 00100 00001

10000 00A00 00001
10000 01110 00001
00000 A1Xa0 00001
10000 01110 00001
10000 00A00 00001

10001 00100 00001
10111 00100 00001
10000 00100 00A01
10000 00100 00001
11111 11111 11111
8
