11111 11011 11111
10000 00000 00001
10000 00000 00001
10000 01010 00001
10000 A1A1A 00001

10011 11111 11001
10000 00000 00001
100C2 A111A 2C001
10000 00000 00001
10011 11111 11001

10000 A1A1A 00001
10000 01010 00001
10000 00000 00001
10000 00000 00001
11111 11011 11111
8
