11111 11011 11111
10000 00030 00001
10010 13331 00A01
10111 00300 00001
10011 00300 00001

10000 00300 00001
10010 33333 00301
1AA10 D000D 00300
10010 33333 00301
10000 00300 00001

10000 00300 00001
10020 00300 00001
10000 11311 00001
11000 00C00 00001
11111 11111 11111
8
