11111 11011 11111
10000 00000 00001
10100 00000 00001
10000 00000 00001
10000 00000 20001

10000 A101A 00101
10000 10001 00101
0W000 0A201 00101
10000 10001 00101
10000 A101A 00101

10000 00000 20001
10000 01010 00001
10100 11011 00001
10000 00000 00001
11111 11011 11111
8
