11111 11011 11111
10000 00000 00001
10000 00000 00001
10000 00000 00001
10000 00000 00001

10000 00000 00001
10111 11111 11101
101A0 00000 0A101
10100 0AAA0 00101
10100 00000 00101

10000 00000 00001
10111 11111 11101
10000 00B00 00001
10000 00X00 00001
11111 11111 11111
8
