11111 11011 11111
10001 70001 CCCC1
10001 70001 CCCC1
10001 70001 CCCC1
10001 70001 CCCC1

10001 70001 11111
10001 70CC0 00001
10001 70CC0 00000
10001 70000 00001
10001 77777 77771

10001 11111 11111
10000 00000 00001
11100 00000 00001
10100 00000 00001
11111 11111 11111
3
