11111 11111 11111
13333 33333 33331
13333 33333 33331
13333 33333 33331
13333 33333 33331

13333 33333 33331
13333 34444 44431
13333 34C00 00000
13333 34000 11111
13333 34000 0AAA1

13333 34000 0AAA1
13333 34000 11111
13333 33000 00001
13333 33000 00001
11111 11011 11111
8
