11111 11011 11111
10000 02000 00001
10000 01000 02001
10000 01000 00201
10000 00100 00001

10000 11111 00031
12110 11111 00031
00001 11111 00A31
10000 11111 00031
10000 11111 00031

10000 00000 00001
10200 00000 00001
10020 00A00 00A01
10000 33333 00001
11111 11111 11111
8
