11111 11011 11111
10000 01010 00001
100a0 01010 00001
10000 01010 0A001
10000 01010 10101

10000 01010 00001
10111 11010 00001
10A00 A0010 00000
10111 11010 00001
10000 01010 00001

100a0 01010 00001
10000 01C10 00001
10000 01110 00001
10000 00000 00001
11111 11111 11111
8
