11111 11111 11111
10002 00100 00001
1000W 00100 00001
10002 00100 00001
10001 00000 10001

10001 00000 10001
10000 33333 10001
00000 33333 10000
10000 33333 10001
10001 00000 00001

10001 10901 10001
10000 10001 00001
10000 10001 00001
10000 10001 00001
11111 11011 11111
8
