11111 11011 11111
1C000 00000 00001
10000 00000 00001
1000A 10000 00001
100AA 10000 00001

10011 10001 11111
10000 00000 00001
00000 00a00 00001
10000 000A0 00001
10000 10000 00001

10000 10000 00001
10000 10000 00001
10000 10000 00001
10000 10000 00001
11111 11111 11111
8
