11111 11111 11111
10000 10000 100A1
10110 01010 10101
101A0 01A10 10101
10111 01010 10101

10001 01010 10101
11101 01010 10101
00303 03C30 30300
10101 01010 10111
10101 01010 10001

10101 01010 11101
10101 01A10 0A101
10101 01010 01101
1A001 00001 00001
11111 11111 11111
3
