11111 11011 11111
10000 00000 00001
10000 01010 00001
10000 01010 00001
10000 01010 00001

10000 00000 00001
10010 A000A 01001
10010 A0X0A 01001
10010 A000A 01001
10000 00000 00001

10000 01010 00001
10000 01010 00001
10000 01010 00001
10000 00000 00001
11111 11111 11111
8
