11111 11011 11111
13333 30000 00001
13331 10001 10A01
13331 00000 10001
13111 00000 11001

13100 00000 01001
10000 00a00 01001
00000 0aCL0 01001
10000 00L00 01001
10100 0000A 01001

10111 00000 11001
10001 11111 10A01
10A00 00000 0AC01
10000 00000 00001
11111 11111 11111
3
