11111 11111 11111
10000 00000 00001
10000 10000 00a01
10000 1A000 00001
10000 01110 00001

10110 00001 00001
100A1 00001 00001
10001 00PB1 00000
10001 00B01 00001
10000 1111w 00001

10000 00000 00001
10000 00000 00001
10a00 00000 00001
10000 00000 00001
11111 11011 11111
b
