11111 11111 11111
10000 00000 00001
10a00 00001 00001
10000 000A1 00001
10000 01110 00001

10000 10000 01101
10000 10000 1A001
00000 1BX00 10001
10000 10B00 10001
10000 w1111 00001

10000 00000 00001
10000 00000 00001
10000 00000 00a01
10000 00000 00001
11111 11011 11111
b
