11111 11011 11111
10000 00000 00001
10000 00000 11101
10000 00001 00001
10000 00110 00001

10000 01000 00001
100A0 01000 00001
100Aa 01000 BBB01
100A0 01000 00001
10000 01000 00001

10000 00110 00001
10000 00001 00001
10000 00000 11101
10000 00000 00001
11111 11011 11111
b
