11111 11011 11111
10000 00000 00001
10111 00000 00001
10000 10000 00001
10000 01100 00001

10000 00010 00001
10000 00010 0A001
10BBB 00010 aA001
10000 00010 0A001
10000 00010 00001

10000 01100 00001
10000 10000 00001
10111 00000 00001
10000 00000 00001
11111 11011 11111
b
