11111 11111 11111
10000 00000 00001
10000 00w00 00001
10111 00000 00001
10100 00000 00001

10000 22222 00001
10000 00002 00001
10A00 000B9 00000
10000 00002 00001
10100 22222 00001

10100 00000 33331
10000 00033 A0001
10A01 10000 00001
10000 00000 00001
11111 11011 11111
b
