11111 11011 11111
13300 00000 00331
13111 11011 11131
10100 00000 00101
10100 01110 00101

10100 00000 00101
10101 00B00 10101
00001 0BBB0 10000
10101 00B00 10101
10100 00000 00101

10100 01110 00101
10100 00000 00101
13111 11011 11131
13300 00000 00331
11111 11011 11111
b
