11111 11111 11111
10000 00000 00001
10000 00B00 00001
10000 00000 00001
10001 10001 10001

10001 00000 10001
10003 00000 30001
000A3 00500 3A000
10003 00000 30001
10001 00000 10001

10001 10001 10001
10000 00000 00001
10000 00B00 00001
10000 00000 00001
11111 11111 11111
B
