11111 11011 11111
10000 00000 00001
10A00 11011 00A01
10000 00000 00001
10000 00000 00001

10100 00000 00101
10101 00000 10101
00001 00B00 10000
10101 00000 10101
10100 00000 00101

10000 01110 00001
10000 00000 00001
10200 01w10 00201
10000 01010 00001
11111 11111 11111
b
