11111 11111 11111
10000 00111 11111
10000 00111 11111
10000 00111 11111
10000 00000 01111

10000 1111a 01111
10000 00001 01111
00000 0AB01 01111
11101 00A01 00001
10001 00001 00001

1000B 11000 00001
100B0 00000 00001
10B00 01000 00001
10000 01000 00001
11111 11011 11111
b
