11111 11011 11111
10000 00000 00001
10000 00000 00001
10A00 11111 00A01
10000 00000 00001

11111 00B00 11111
10000 00000 00001
10A00 11111 00A01
10000 00000 00001
11111 00B00 11111

10000 00000 00001
10000 11111 00001
10000 00a00 00001
10000 00X00 00001
11111 11111 11111
b
