11111 11011 11111
10000 00000 00001
10000 01000 00001
10000 01000 00001
10000 01A02 a0001

10002 00000 00001
10000 11110 11101
10B00 00w10 A0000
10000 11110 00001
10000 00000 20001

10000 20A10 00001
10000 00010 00001
10000 00010 00001
10000 00000 00001
11111 11011 11111
b
