11111 11111 11111
10000 00000 00001
1001A 10000 02201
10010 10000 00201
10000 00011 B0001

10000 00001 10001
10111 01000 10001
00001 01B00 00001
11101 01110 00001
10001 00000 00001

1000w 11100 00001
10000 01000 00001
1AAA1 01000 00001
1aaa1 00000 00001
11111 11011 11111
b
