11111 11011 11111
10000 01010 00001
10000 00000 00001
10000 11010 00001
10000 10000 00001

10000 10000 00001
10A00 1A010 01011
1aAa0 10a00 00000
10A00 1A010 01011
10000 10000 00001

10000 10000 00001
10000 11010 00001
10000 00000 00001
10000 01010 00001
11111 11011 11111
1
