11111 11111 11111
10000 00000 00001
10000 00000 00w01
10000 00000 00001
1000B 00000 11111

10010 22222 00001
10010 20000 00001
10B10 00000 00000
10010 20000 00001
10010 22222 00001

1000B 00000 11111
10000 00000 00001
10000 00000 00a01
10000 00W00 00001
11111 11011 11111
b
