11111 11011 11111
10000 00000 00001
10a00 00000 00001
10000 00000 1A001
10000 00100 01001

10000 B212A 01001
10000 22122 01001
0W001 11111 1A001
10000 22122 01001
10000 B212A 01001

10010 00100 01001
100A1 11A11 1A001
10000 00000 00001
10000 00000 00001
11111 11111 11111
b
