11111 11011 11111
10000 00000 00001
01010 01010 01010
01010 01010 01010
01010 01010 01010

01010 01010 01010
01a10 01a10 01a10
1001A 01010 A1001
10001 10001 10001
10000 00X00 00001

10000 00000 00001
10B01 00000 10B01
10001 00B00 10001
10000 10001 00001
11111 11111 11111
b
