11111 44044 11111
10003 30003 30001
10003 30003 30001
10003 33333 30001
10000 33333 00001

10000 03330 00001
10000 03330 00001
100B0 03D3w 00000
10000 03330 00001
10000 03330 00001

10000 00A00 00001
10000 00000 00001
10000 00000 00001
10000 00000 00001
11111 11011 11111
b
