11111 11011 11111
10000 01010 00001
10000 01010 00w01
10000 01010 00001
10000 01010 00001

10000 01010 00001
10000 11011 00w01
0W00a 10000 w0w01
10000 11011 00w01
10000 01010 00001

10000 01010 00001
10000 01010 0w001
10000 01010 00001
10000 00a00 00001
11111 11111 11111
b
