11111 11111 11111
10000 00a00 00001
10000 02220 00001
10000 02020 00001
10000 00900 00001

10000 02020 00001
10001 02220 10001
000A1 00000 1A000
10001 02220 10001
10000 02020 00001

10000 00200 00001
10000 02020 00001
10000 02220 00001
10000 00a00 00001
11111 11111 11111
1
