11111 11111 11111
10000 00000 00001
10000 00000 00001
10000 a111a 00001
10000 10A01 00001

10001 00000 10001
10000 00000 00001
00000 00000 00000
10000 00000 00001
10001 00000 10001

10000 10A01 00001
10000 a111a 00001
10000 00000 00001
10000 00000 00001
11111 11111 11111
1
