11111 11011 11111
10000 00000 00001
11111 11011 11111
10000 00000 00001
11111 11Y11 11111

10000 00000 00001
11111 11011 11111
10000 00000 00001
11111 11011 11111
10000 00000 00001

11111 11011 11111
10000 00000 00001
11111 11511 11111
10000 00000 00001
11111 11111 11111
b
