22222 22222 22222
10000 00000 00001
10000 07000 00001
10000 70700 00001
17777 00700 00001

10000 00700 00001
10000 00700 aAAA1
00000 00a70 aAAA1
10000 00700 aAAA1
10000 00700 00001

17777 00700 00001
10000 70700 00001
10000 07000 00001
10000 00000 00001
22222 22922 22222
1
