11111 11111 11111
10000 000A0 00001
10000 00000 00001
10000 22222 00001
10000 00000 00001

10200 00100 00101
10A00 10700 01001
10209 A0700 10000
10A00 10700 01001
10200 00100 00101

10000 00000 00001
10000 22222 00001
10000 00000 00001
10000 000A0 00001
11111 11111 11111
1
