11111 11011 11111
12200 00000 00221
120A0 00000 0A021
10000 00000 00001
12000 02220 00021

12200 00000 00221
10000 01010 00001
00000 00000 00000
10000 01010 00001
12200 00000 00221

12000 02220 00021
10000 00000 00001
120A0 00000 0A021
12200 00000 00221
11111 11011 11111
1
