11111 11111 11111
10000 00000 00001
10000 00A00 00001
10000 00000 00001
10000 01110 00001

10000 10A01 00001
10000 10001 00001
00000 10001 00000
10111 00200 11101
10000 00000 00001

10000 00A00 00001
10000 01110 00001
10000 00000 00001
10000 00000 00001
11111 11011 11111
1
