11111 11011 11111
10000 00000 00001
10200 01010 00201
10000 01010 00001
10000 01010 00001

10000 00000 00001
10111 0A0A0 11101
00000 00200 00000
10111 0A0A0 11101
10000 00000 00001

10000 01010 00001
10000 01010 00001
10200 01010 00201
10000 00000 00001
11111 11011 11111
1
