11111 11111 11111
10000 00000 00001
10000 00000 00001
10000 00500 00001
10003 33333 30001

10003 00000 30001
10003 00000 30001
10003 00000 30001
10003 00000 30001
10003 00000 30001

10003 00000 30001
10003 00000 30001
10003 00000 30001
10000 00Y00 00001
11111 11011 11111
3
