11111 11111 11111
10000 70000 00001
10000 70000 00001
10000 70000 0A201
10000 70000 00001

10000 7777a 00001
10000 00007 00001
00000 77777 00000
10000 70000 00001
10000 a7777 00001

10000 00007 00001
102A0 00007 00001
10000 00007 00001
10000 00007 00001
11111 11111 11111
1
