11111 11111 11111
13333 33000 000L1
13333 33000 00001
13333 33000 00001
1333D 33000 00001

13333 D3000 11101
13333 33000 10001
10000 00000 00000
10000 00033 33331
10000 0003D 33331

10000 11033 D3331
10000 10033 33331
10000 10033 33331
1L000 00033 33331
11111 11011 11111
3
