11111 11111 11111
10000 10A01 00001
10010 00000 01001
10110 02220 01101
10000 00000 00001

10200 02220 00201
10200 00000 00201
0020L C222C L0200
10200 00000 00201
10200 02220 00201

10000 00000 00001
10110 02220 01101
10010 00000 01001
10000 10A01 00001
11111 11111 11111
3
