11111 11111 11111
1000C 01000 00001
10000 10000 10001
10000 10011 00001
10000 10100 00001

10001 00100 11001
10001 001A1 00001
00000 0L101 a0100
10001 00101 00001
10001 00100 11001

10000 10100 00001
10000 10011 00001
10000 10000 10001
1000C 01000 00001
11111 11111 11111
3
