11111 11011 11111
13330 00000 03331
10033 00000 33001
10003 30003 30001
10110 33W33 01101

10000 00C00 00001
10000 01110 00001
00000 C101C 00000
10000 01010 00001
10000 00000 00001

10110 00100 01101
10000 00000 00001
10000 10001 00001
1L000 10501 000L1
11111 11111 11111
3
