11111 11111 11111
10000 00C00 00001
10000 00000 00001
10000 10001 00001
10110 1C0C1 01101

10000 11111 00001
10000 10001 00001
00000 00L00 00000
10000 10001 00001
10000 11111 00001

11001 1C0C1 10011
10000 10001 00001
10000 00000 00001
10000 00C00 00001
11111 11111 11111
3
