11111 11111 11111
10000 00200 00001
10000 00200 00001
10000 00200 00001
10000 00C00 00001

10022 00L00 22001
10000 22222 00001
0000A 33333 A0000
10000 22222 00001
10022 00L00 22001

10000 00C00 00001
10000 00200 00001
10000 00200 00001
10000 00200 00001
11111 11111 11111
3
