11111 11111 11111
10000 00000 00001
10100 00000 01101
10000 02220 0L101
10000 00000 00001

10011 00011 00001
1001C 000C1 00201
00000 00000 00201
1001C 00000 00201
10011 00000 00001

10000 00000 00001
10110 1L0L1 00001
10C10 11011 00101
10000 00000 00001
11111 11011 11111
3
