11111 11011 11111
1a000 00000 20001
10111 02020 20A01
101C0 02020 20001
10100 02000 22221

10000 00001 00001
10100 00001 00001
10100 00001 00000
10100 000L1 00001
10000 01111 00001

10100 00000 00101
101C0 00000 0C101
10111 01110 11101
1a000 00000 000a1
11111 11111 11111
3
