11111 11111 11111
10000 00000 00001
10100 00L00 00101
10010 00000 01001
10001 00000 10001

10000 13D31 00001
10000 33333 00001
000A0 D373D 0A000
10000 33333 00001
10000 13D31 00001

10001 00000 10001
10010 00000 01001
10100 00L00 00101
10000 00000 00001
11111 11111 11111
3
