11111 11111 11111
10000 00000 00001
10000 00L00 00001
10000 00000 00001
10011 11111 11001

10000 00000 00001
10000 10A01 00001
0000a 1C0C1 a0000
10000 10A01 00001
10000 00000 00001

11111 11111 11111
10001 00000 10001
10001 22222 10001
10001 00000 10001
11111 11111 11111
3
