11111 11111 11111
10000 00000 00001
10000 02220 00001
10000 00L00 00001
10000 02220 00001

10000 00000 00001
10110 01110 01101
0000L 01X10 L0000
10110 01110 01101
10000 00000 00001

10000 1CCC1 00001
100a0 10001 00a01
10000 10001 00001
10000 10001 00001
11111 11911 11111
3
