11111 11111 11111
10000 10L01 00001
100A0 10001 0A001
10000 00000 00001
10111 00000 11101

10000 33333 00001
10000 33333 00001
00000 33D33 00000
10000 33333 00001
10000 33333 00001

10111 00000 11101
10000 00000 00001
100A0 10001 0A001
10000 10L01 00001
11111 11111 11111
3
