11111 11111 11111
10100 00000 00101
11110 00000 01111
101C0 00000 0C101
10000 00100 00001

10000 00100 00001
10000 00000 00001
00001 10a01 10000
10000 00000 00001
10000 00100 00001

10000 00100 00001
101C0 00000 0C101
11110 00000 11111
10100 00000 00101
11111 11111 11111
3
