11111 11011 11111
10100 01000 00001
11LL1 01000 00001
10L11 00000 10001
10111 11111 10001

10001 00000 00001
11101 00000 00001
00001 00L00 00L01
10001 00000 00001
10001 00000 00001

10011 00000 11101
10000 00000 10001
10000 00L00 10001
10000 00000 00001
11111 11111 11111
3
