11111 11011 11111
10000 00000 00001
10000 00000 00001
10000 00000 00001
10000 00000 00001

10111 10001 11101
10000 01010 00001
10000 01U10 00001
10000 01110 00001
11111 10001 11111

10000 00000 00001
10000 00000 00001
1AAAA AAAAA AAAA1
10000 00000 00001
11111 11111 11111
3
