11111 11111 11111
10000 00000 00001
10Y00 02220 00001
10000 00000 00001
10000 00000 00001

10000 02020 00001
10200 22022 00001
1M200 00M00 00000
10200 22222 00001
10000 00000 00001

10000 00000 00001
10000 0M0M0 01101
10000 00000 01C01
10000 00000 00001
11111 11011 11111
5
