11111 11011 11111
10000 00000 00001
10222 22022 22201
10200 00000 00201
10200 00000 00201

10200 00R00 00201
10200 00000 00201
00000 S000Y 00000
10200 00T00 00201
10200 00000 00201

10200 00000 00201
10200 00000 00201
10222 22022 22201
10000 00000 00001
11111 11011 11111
1
