11111 11111 11111
10000 00100 00001
10A00 00100 00A01
10000 00100 00001
10000 00100 00001

10000 00100 00001
10000 00100 00001
00000 00100 00000
10000 00100 00001
10000 00B00 00001

10000 00000 00001
10000 00000 00001
100w0 00000 00w01
10000 00000 00001
11111 11011 11111
b
