11111 11111 11111
10000 00100 00001
10B00 0A1A0 00w01
10000 00100 00001
10000 00100 00001

10000 00000 00001
10220 22222 00A01
00000 21112 01111
10220 22122 00A01
10000 02220 00001

10000 00000 00001
10000 02020 00001
10a00 02020 00B01
10000 00000 00001
11111 11011 11111
b
