11111 11111 11111
10000 00000 00001
10000 00000 00001
10001 11111 10001
10001 A000A 10001

10001 00000 10001
10001 00000 10001
10001 00000 10000
10111 00000 11101
10001 00000 10001

10001 00000 10001
10001 00000 1a001
10001 00500 10001
10000 00000 00001
11111 11111 11111
6
