11111 11111 11111
10000 00100 00001
10000 00100 00001
10000 00100 00001
10A00 00100 00A01

10000 00100 00001
10000 00100 00001
00000 00W0A 00000
10000 00100 00001
10000 00100 00001

10A00 00100 00A01
10000 00100 00001
10000 00100 00001
10000 00100 00001
11111 11111 11111
6
