11111 11111 11111
10000 00100 00001
10000 00100 00001
10000 00100 00a01
10000 00100 00001

10000 00100 00001
10000 a010A 00001
0000A 00W00 00000
10000 a010A 00001
10000 00100 00001

10000 00100 00001
10000 00100 00a01
10000 00100 00001
10000 00100 00001
11111 11111 11111
6
