11111 11111 11111
1A000 00000 00051
10111 11111 11111
10122 22222 22221
10120 00000 00021

10120 00000 00021
10120 00000 00021
00120 00q00 00021
10120 00000 00021
10120 00000 00021

10120 00000 00021
10120 00000 00021
10120 00000 00021
10122 22222 22221
11111 11111 11111
6
