11111 11011 11111
10001 00000 00001
10111 01010 00001
10100 00100 11001
11100 00000 01001

10000 00000 00001
10000 00C00 00001
00000 0C100 00101
10000 000C0 00101
10000 00000 00001

10010 00000 00111
10011 00000 00001
10000 00110 10001
10000 00000 10001
11111 11111 11111
5
