11111 11111 11111
10000 00000 00001
10000 0CCC0 00001
10000 00000 00001
10000 00000 00001

10000 22222 00001
10C00 20000 00001
10C00 20L00 00000
10C00 20000 00001
10000 22222 77771

10000 00000 00001
10A00 00000 00001
10000 00002 00C01
10000 00002 00001
11111 11911 11111
3
