11111 11111 11111
10000 00000 00001
10B00 00000 00B01
10000 00000 00001
10000 07770 00001

1000A 10001 00001
10002 00000 11111
10009 a0w00 00000
10002 00000 11111
1000A 10001 00001

10000 07770 00001
10000 00000 00001
10B00 00000 00B01
10000 00000 00001
11111 11011 11111
b
