11111 11011 11111
10000 00000 00001
10100 00000 00101
10010 00000 01001
10B01 00000 10B01

10010 01010 01001
10100 10001 00101
00001 00A00 10000
10100 10001 00101
10010 01010 01001

10B01 00000 10B01
10010 00000 01001
10100 00000 00101
10000 00000 00001
11111 11011 11111
b
