11111 11011 11111
10000 00000 00001
10B00 11111 00B01
10000 00000 00001
10000 00000 00001

10100 00200 00101
10100 02020 00101
001a0 20502 0a100
10100 02020 00101
10100 00900 00101

10000 00000 00001
10000 01110 00001
10A00 1www1 00A01
10000 00000 00001
11111 11111 11111
b
