11111 11011 11111
10000 00000 00001
10B00 00000 00B01
10000 00000 00001
10000 00000 00001

1000A 77777 00001
10002 0ABA0 20001
00002 ABYBA 9Aa01
10002 0ABA0 20001
1000A 77777 00001

10000 07770 00001
10000 00000 00001
10011 07770 11001
1000w 70007 w0001
11111 11011 11111
b
