11111 11111 11111
10000 0GGG0 00001
10000 00000 00001
10000 00000 00001
10000 01110 00001

10000 00000 00001
10000 00000 00001
10G00 01110 00G01
10000 00000 00001
10000 00000 00001

10000 01110 00001
10000 00000 00001
10000 00900 00001
10000 00000 00001
11111 11011 11111
9
