11111 11111 11111
10000 00000 00001
17777 77777 77101
10000 00000 00101
10000 00700 00101

10000 00000 00101
10110 00G00 00101
10100 G000G 10100
10110 00G00 00101
10000 00000 00101

10000 00700 00101
10000 00000 00101
10111 11111 11101
10000 00000 00901
11111 11011 11111
9
