11111 11011 11111
10000 07070 00001
10G00 70007 00G01
10000 70007 00001
10000 G777G 00001

10110 00000 00001
10001 00000 00001
00001 00G00 00001
10001 00000 00001
10110 00000 00001

10000 00000 00001
10000 00000 00001
10G00 00000 00G01
10000 00000 00001
11111 11111 11111
9
