11111 11111 11111
10000 00000 00001
10000 00000 00A01
10000 00000 00001
10000 00000 00001

10000 00C00 00001
17770 00000 07001
00000 C0L0C 07000
17770 00000 07001
10000 00C00 00001

10000 00000 00001
10000 07770 00001
10A00 00000 00A01
10000 00000 00001
11111 11911 11111
3
