11111 11011 11111
100B0 00000 10B01
10A00 00000 1AAA1
1B000 00000 10001
10000 00000 10001

10000 00000 10001
10000 00a00 00001
10000 77777 00000
10007 00000 70001
10007 00000 70001

10007 00000 70001
10007 00000 70001
10007 00000 70001
10007 00000 70001
11111 11011 11111
b
