11111 11111 11111
10000 0B000 00001
10000 00000 00001
10000 0B000 00001
10700 0w000 00001

10100 00w00 00001
10100 000w0 00001
00100 000w0 00091
10100 000w0 00001
10100 00w00 00001

10700 0w000 00001
10000 0B000 00001
10000 00000 00001
10000 0B000 00001
11111 11111 11111
b
