11111 11011 11111
10000 00001 000G1
10000 00001 00001
10000 00000 0G001
12220 00000 G0001

10000 77771 00111
10000 000G1 00001
10G00 00001 00000
10000 00001 00001
10000 00001 00001

12222 00000 00001
10002 00000 20001
10Y09 00G00 20001
10002 00000 20001
11111 11111 11111
9
