11111 11011 11111
1G000 00000 000G1
10001 00000 10001
100G1 01010 1G001
10110 00000 01101

10000 01010 00001
10100 11011 00101
00000 00G00 00000
10100 11011 00101
10000 01010 00001

10110 00000 01101
100G1 01010 1G001
10001 00000 10001
1G000 00000 000G1
11111 11011 11111
9
