11111 11911 11111
10000 00000 00001
10000 00100 00001
10000 01010 00001
10000 00000 00001

10000 00000 00001
10010 01G10 01001
00100 0G0G0 00100
10010 01G10 01001
10000 00000 00001

10000 00000 00001
10000 01010 00001
10000 00100 00001
1G000 00000 000G1
11111 11011 11111
9
