11111 11011 11111
10000 00000 00001
10000 10001 00001
10000 00000 00001
10000 0G0G0 00001

10000 11111 00001
17777 10001 77771
00000 00G00 00000
17777 10001 77771
10000 11111 00001

10000 0G0G0 00001
10000 00000 00001
10000 10001 00001
10000 00000 00001
11111 11011 11111
9
