11111 11111 11111
10000 00100 00001
10000 00100 00001
10111 11111 11101
10100 00000 00101

10100 00000 00101
10000 00000 00001
00000 00K00 00000
10000 00000 00001
10100 00w00 00101

10100 00000 00101
10111 11111 11101
10000 00100 00001
10000 00100 00001
11111 11111 11111
d
