11111 11011 11111
10000 00000 00001
10111 11011 11101
101K0 00000 0K101
10101 01110 10101

10100 00K00 00101
10101 01110 10101
00001 K1Y1K 10000
10101 01110 10101
10100 00K00 00101

10101 01110 10101
101K0 00000 0K101
10111 11011 11101
10000 00000 00001
11111 11011 11111
d
