11111 11111 11111
10000 00000 000a1
10000 00000 00001
10000 00000 00001
10000 00000 00001

10000 000CL 00001
10000 0000C 00001
00010 00100 00001
10000 00000 00001
10000 A0000 00001

10000 00000 00001
10000 00100 00001
10000 00000 00001
10000 00000 00001
11111 11011 11111
3
