11111 11111 11111
10000 00000 00001
10000 00G00 00001
10000 00000 00001
11111 00000 11111

10000 00G00 00001
10000 11111 00001
10000 1F0F1 00000
10000 00000 00001
10000 00000 00001

1001A 00000 00001
10011 11100 00G01
10000 00000 10001
10000 00000 10001
11111 11011 11111
9
