11111 11111 11111
10100 00000 00101
10100 00000 00101
10000 00000 00001
10000 10001 00001

10000 10001 00001
10000 0F2F0 00001
00000 02220 00000
10010 0F2F0 01001
10010 00000 01001

10000 00000 00001
10000 01010 00001
10001 01010 10001
10001 00000 10001
11111 11111 11111
9
