11111 11111 11111
1a100 00000 001a1
10100 00000 00101
10100 00A00 00101
10100 00F00 00101

10000 10001 00001
10000 10001 00001
00000 1GGG1 00000
10000 10001 00001
10000 10001 00001

10100 00F00 0a101
10100 00A00 00101
10100 00000 00101
1a100 00000 001a1
11111 11111 11111
9
