11111 11111 11111
10000 00500 00001
10000 00000 00001
10666 66666 66601
10066 66666 66001

10006 00600 60001
10066 66666 66001
10000 60006 00001
10000 60006 00001
10000 60006 00001

1000d 60506 d0001
10000 00000 00001
10000 00000 00001
10003 33333 30001
11444 44344 44411
c
