11111 11111 11111
10000 00000 00001
1G900 00000 00001
10000 00000 00001
10000 11100 00001

10000 00100 11101
10001 00000 0G101
10001 00000 0G100
10001 00000 0G101
10000 00100 11101

10000 00000 00001
10000 00000 00001
1G200 00000 00001
10000 00000 00001
11111 11111 11111
9
