11111 11111 11111
10000 00100 00001
10000 00100 00001
10000 00000 00001
10000 10000 00001

10001 10000 00001
10000 00G00 00111
00000 F000F 00000
11100 00G00 00001
10000 00001 10001

10000 00001 00001
10000 00000 00001
10000 00100 00001
10000 00100 00001
11111 11111 11111
9
