11111 11111 11111
10000 00000 00001
10100 00G00 00101
10100 00G00 00101
10100 00000 00101

10100 00000 00101
10000 11111 00001
00000 0FFF0 00000
10000 11111 00001
10100 00000 00101

10100 00000 00101
10100 00G00 00101
10100 00G00 00101
10000 00000 00001
11111 11111 11111
9
