11111 11111 11111
10000 00000 00001
10000 00F00 00001
10000 00G00 00001
10000 22222 00001

10000 00000 00001
10000 00000 00001
00000 0F0F0 00000
10000 00000 00001
10011 11111 11001

10000 00G00 00001
10000 00G00 00001
10000 00F00 00001
10000 00000 00001
11111 11111 11111
9
