11111 11111 11111
10000 00000 00001
10000 00000 00001
10000 00000 00001
10000 0000G G0001

10000 22222 G0001
10000 000G2 00001
00000 00G02 00001
10000 0G002 00001
10000 G0002 00001

10000 00000 00001
10000 00000 00001
10000 00000 00001
10000 00000 00001
11111 11011 11111
9
