11111 11011 11111
1F001 00000 00001
10000 00000 00001
10000 00000 00001
10001 11111 00001

10001 00000 00001
10001 00F00 00001
1A001 00F00 00201
10001 00A00 00201
10001 00000 00201

10000 00000 00201
10000 00G00 00201
10000 00011 11201
10000 00000 00901
11111 11011 11111
9
