11111 11111 11111
10000 00000 00001
10FG0 00000 00001
10GA0 00100 00001
10000 00100 00001

10000 11111 00101
10000 1F000 00101
10000 10F00 00100
10011 100F0 00101
10000 1000F 00101

10000 00000 00101
10000 00000 0G201
10000 11111 12901
10000 00000 00021
11111 11011 11111
9
