11111 11111 11111
10000 00F00 00001
10111 11111 11101
10000 00001 00001
10000 00001 00001

10000 10001 00001
10000 10A01 00001
00000 1GFG1 00000
10000 10A00 00001
10000 10000 00001

10000 10000 00001
10000 10000 00001
10111 11111 11101
10000 00F00 00001
11111 11111 11111
9
