11111 11111 11111
1000G 0G0G0 G0001
10010 10101 01001
10010 10101 01001
10010 10101 01001

10010 10101 01001
10010 10101 01001
00010 10101 01000
10010 10101 01001
10010 10101 01001

10010 10101 01001
10010 10101 01001
10010 10101 01001
1000G 0G0G0 G0001
11111 11111 11111
9
