11111 11011 11111
10000 00000 00001
10001 00000 10001
100G1 00000 1G001
10011 00000 11001

10000 20002 00001
10000 00000 00001
00000 00200 00000
10020 00900 02001
10000 00F00 00001

10000 00000 00001
10000 00000 00001
10200 02220 00201
10G00 00G00 00G01
11111 11111 11111
9
