11111 11111 11111
10000 00000 00001
1000G 00000 G0001
10000 00000 00001
10000 00000 00001

10001 00000 10001
10001 00000 10001
00001 F000F 10000
10001 00000 10001
10001 00G00 10001

10001 11011 10001
10000 00000 00001
10000 00000 00001
10000 00G00 00001
11111 11111 11111
9
