11111 11111 11111
10000 00000 00001
10000 11111 10001
10000 00000 10001
10000 00000 10001

10000 00000 10001
10000 00000 10001
00000 00FFF 10F01
10000 00000 10001
10000 00000 10001

10000 00000 10001
10000 00000 00001
10000 11111 10001
10000 10000 00001
11111 11011 11111
9
