11111 11011 11111
10000 00000 00001
10000 00000 00001
11111 00000 11111
10000 00000 00001

10000 22922 00001
10000 20002 00001
10F00 20002 00F01
10G00 20002 00G01
10000 20002 00001

10000 00000 00001
10000 00000 00001
10000 00000 00001
10000 00000 00001
11111 11011 11111
9
