11111 11011 11111
10000 00000 00001
10000 00000 00001
10000 00000 00001
10000 F000F 00001

10000 10002 00001
10000 10002 00001
10000 10002 00001
10011 0F0F0 22001
10000 02010 00001

10000 02010 00001
10000 00000 00001
10111 11111 11101
10000 00000 00001
11111 11011 11111
9
