11111 11011 11111
10000 00000 00001
10a00 00000 00a01
10000 00000 00001
10000 00000 00001

10000 11111 00001
10000 10001 00001
1000G 10001 G0001
1000G 10001 G0001
1000G 10001 G0001

10000 00F00 00001
10011 11111 11001
10000 00000 00001
10000 00000 00001
11111 11011 11111
9
