11111 11111 11111
10000 00000 00001
10F00 00F00 00F01
100o0 00000 00001
10002 22222 00001

10002 00000 20001
10002 00000 20001
10F02 00500 00000
10002 00000 20001
10002 00000 20001

10000 22022 00001
10000 00000 00001
10F00 00000 00F01
10000 00000 00001
11111 11011 11111
9
