11111 11111 11111
10010 00000 01001
10010 00000 01001
11110 00100 01111
10000 00100 00001

10000 00100 00001
10000 0A1A0 00001
00000 AF1FA 00000
10011 11111 11001
10000 00F00 00001

10000 00000 00001
11110 F000F 01111
10010 00000 01001
10010 00000 01001
11111 11111 11111
9
