11111 11111 11111
10000 00000 00001
10000 00000 00001
10000 00000 0a001
10000 00000 G0001

10000 11111 00001
10111 000F1 00001
00000 00F01 00001
10000 0G001 00001
10000 00001 00001

10000 00010 00001
10000 00010 00001
10000 00010 00001
10000 00000 00001
11111 11011 11111
9
