11111 11011 11111
10000 00000 00001
10000 00000 00001
10011 11111 11001
10000 00000 00001

10001 00100 10001
10001 0G1G0 10001
00001 00000 10000
10001 0G1G0 10001
10001 00100 10001

10000 00000 00001
10011 11111 11001
10000 00000 00001
10000 00000 00001
11111 11111 11111
9
