11111 11011 11111
10000 00000 00001
10000 00000 00001
100a2 00000 2a001
10022 00000 22001

10000 00200 00001
10000 0F2F0 00001
10000 22222 00001
10000 0F2F0 00001
10000 00200 00001

10022 00000 22001
100a2 00000 2a001
10000 00000 00001
10000 00000 00001
11111 11011 11111
9
