11111 11011 11111
10000 00000 00001
10000 00000 00001
10000 00G00 00001
10000 01110 00001

10000 00000 00001
10000 00000 00001
1000F 00F00 F0001
10000 00000 00001
10001 11111 10001

10000 00G00 00001
10000 00000 00001
10000 00000 00001
10000 00000 00001
11111 11011 11111
9
