11111 11011 11111
10000 00000 00001
10000 00000 00001
10000 00100 00001
10000 01110 00001

10000 01110 00001
10000 01110 00001
10000 F111F 00001
10000 F111F 00001
10002 22222 20001

10000 FF2FF 00001
10000 00200 00001
10000 00000 00001
10000 00000 00001
11111 11011 11111
9
