11111 11011 11111
10000 00000 00001
10000 00000 00a01
100G0 00000 00001
10000 00000 00001

10000 11111111111
10000 00000 00001
10000 F0F0F 00001
10000 00000 00001
11111 11111 00001

10000 00000 00001
10000 00000 0G001
10a00 00000 00001
10000 00000 00001
11111 11011 11111
9
