11111 11111 11111
11110 00211 11111
11000 00211 11111
10000 00211 11111
10000 00211 11111

10000 00211 11111
10000 00221 11111
00000 0Y521 11111
10000 00221 11111
10000 00211 11111

10000 00211 11111
10000 00211 11111
11000 00211 11111
11110 00211 11111
11111 11111 11111
9
