11111 11011 11111
10000 00000 00001
10000 00000 00001
10000 10F01 00001
10000 11111 00001

10000 00000 00001
10011 00F00 11001
100G1 00G00 1G001
10011 00F00 11001
10000 00000 00001

10000 11111 00001
10000 10F01 00001
10000 00000 00001
10000 00000 00001
11111 11011 11111
9
