11111 11011 11111
10000 00000 00001
10100 00000 00101
10100 00000 00101
10G00 00000 00G01

10000 11111 00001
10000 G0F0G 00001
10000 00200 00001
10000 00200 00001
10000 00200 00001

10A00 00200 00A01
10022 00200 22001
10000 00000 00001
10000 00000 00001
11111 11011 11111
9
