11111 11011 11111
10000 00000 00001
10000 00000 00001
10000 00G00 00001
10000 11111 00001

10000 22222 00001
10000 00000 00001
00000 G020G 00000
10000 00900 00001
10000 22222 00001

10200 11111 00201
1G200 00000 002G1
10200 00000 00201
10000 00000 00001
11111 11111 11111
9
