11111 11011 11111
1G000 00000 000G1
10000 00000 00001
10011 11111 11001
10000 00F00 00001

10010 00000 01001
10010 00000 01001
10010 00000 01051
10010 00000 01001
10000 11111 00001

10000 00000 00001
10000 00000 00001
10000 00500 00001
10000 00000 00001
11111 11111 11111
f
