11111 11011 11111
1A000 00000 000A1
10000 00000 00001
10000 00000 00001
10000 11111 00001

10000 00000 00001
10000 0F0F0 00001
10G00 11111 00G01
10000 0F0F0 00001
10000 00000 00001

1000A 11111 A0001
10000 00000 00001
10000 00000 00001
10000 00000 00001
11111 11011 11111
9
