11111 11011 11111
10000 00010 00001
10000 00010 00001
10000 00010 00001
10000 0a110 00001

10000 11100 00001
10000 10000 11111
10000 10001 10000
10000 10001 a0001
10000 11111 00001

1000G 00000 00001
100F0 00000 00001
10F00 00000 00001
1A000 00000 00001
11111 11111 11111
9
