11111 11111 11111
10000 00G00 00001
10000 00000 10001
100a1 00000 1a001
10011 00002 22001

10000 00000 10001
10000 02220 10001
00000 0FFF0 00000
10001 02220 00001
10001 00000 00001

10022 20000 11001
100a1 00000 1a001
10001 00000 00001
1A000 00G00 00001
11111 11111 11111
9
