11111 11111 11111
10000 00000 00001
10000 00000 00001
10000 00000 00001
10001 0G0G0 10001

10001 11111 10001
10000 00F00 00001
00000 00A00 00000
10000 00F00 00001
10001 11111 10001

10001 0G0G0 10001
10000 00000 00001
10000 00000 00001
10000 00000 00001
11111 11111 11111
9
