11111 11011 11111
11117 00000 00001
11117 00000 00001
11117 00000 00001
17772 22000 00001

10002 F0000 10001
10002 0F000 10001
00000 00F00 1GGG1
10000 000F0 10001
10020 0000F 10001

10000 11111 00001
10000 00000 00001
10000 00G00 00001
10000 00000 00001
11111 11111 11111
9
