11111 11011 11111
10000 00000 00001
10110 00000 01101
101G0 00000 0G101
10000 00000 00001

10000 00100 00001
10000 0a1a0 00001
10000 11111 00001
10000 0a1a0 00001
10000 00100 00001

10000 00000 00001
101G0 00000 0G101
10110 00000 01101
10000 00000 00001
11111 11011 11111
9
