11111 11011 11111
10000 00020 00001
10000 00020 00001
10000 00020 0A001
10000 00020 00001

10000 00020 00001
1F111 10022 22221
10000 00020 00000
10000 00020 00001
10000 F0020 00001

1000F 00020 00001
10000 00F20 00001
10222 22220 00001
1F000 00000 00001
11111 11111 11111
9
