11111 11111 11111
10000 00000 00001
10000 00G00 00001
10000 00000 00001
10222 00000 11101

10000 20001 00001
10000 20001 00001
00000 2FAF1 00000
10000 20001 00001
10000 20001 00001

10222 00000 11101
10000 00000 00001
10000 00G00 00001
10000 00000 00001
11111 11111 11111
9
