11111 11111 11111
10000 00000 00001
10FF0 00000 00001
10000 00000 00001
10000 00G10 00001

10000 0001G 00001
10000 00100 FF101
00000 00100 00100
10000 01000 01001
10000 01000 01001

10000 10000 10001
10000 10000 10001
10001 00001 00001
10001 00001 00001
11111 11111 11111
9
