11111 11111 11111
10000 00000 10001
10000 00000 10001
10000 00000 10001
10001 11111 10001

10000 00000 00001
10001 00F00 00001
00000 0GAG0 00000
10000 00F00 10001
10000 00000 00001

10001 11111 10001
10001 00000 00001
10001 00000 00001
10001 00000 00001
11111 11111 11111
9
