11111 11111 11111
10000 00000 000F1
10000 00000 00001
10000 00000 11001
10000 00011 00001

10000 00200 00001
10000 00200 00001
00000 00900 00000
10000 00200 00001
10000 00200 00001

10000 11000 00001
10011 00000 00001
10000 00000 00001
1F000 00000 00001
11111 11111 11111
9
