11111 11011 11111
10000 00000 00001
10000 00000 00001
10000 00000 00001
10000 00000 00001

10000 00002 00001
10000 00000 00001
00000 00x00 00001
10000 00000 00001
10000 20002 00001

10000 00000 00001
10000 00000 00001
10000 00000 00001
10000 00000 00001
11111 11111 11111
9
