11111 11011 11111
10000 00001 00001
10000 00001 00w01
10000 00001 00001
10000 00001 00001

10000 11111 11111
10000 000K1 00001
10000 00A01 00000
10000 0A001 00001
10000 K0001 00001

10000 00000 00001
10000 00000 00001
10000 00000 00001
10000 00000 00001
11111 11111 11111
d
