11111 11111 11111
10000 00700 00001
10000 00700 00001
10000 0K7K0 00001
10000 00700 00001

10077 11111 77001
10070 00000 07001
00070 00K00 00000
10070 00000 07001
10077 11111 77001

10000 00700 00001
10000 0K7K0 00001
10000 00700 00001
10000 00700 00001
11111 11111 11111
d
