11111 11111 11111
10000 00000 00001
10033 33333 33001
10300 00000 00301
10300 22222 00301

10302 00000 20301
10302 00000 20301
10300 22922 20300
10300 00000 20301
10300 00000 20301

10302 22222 00301
10300 00000 00301
10033 33333 33001
10000 00000 00001
11111 11111 11111
3
