11111 11011 11111
1a000 00000 000a1
11112 00000 21111
10001 00000 10001
10001 00000 10001

10001 00000 10001
10010 00000 01001
00010 00d00 01000
10010 00000 01001
10010 00000 01001

10002 77077 20001
10000 00000 00001
10000 00000 00001
10000 0A0A0 00001
11111 11111 11111
1
