11444 44344 44411
10333 33333 33301
10033 33333 33001
10033 33333 33001
10003 33D33 30001

10000 33333 00001
10000 33333 00001
00000 03330 00a01
10000 00d00 00001
10000 00000 00001

10000 00000 00001
10000 00000 00001
10000 00000 00001
10000 00000 00001
11111 11111 11111
1
