11111 11111 11111
10000 00000 00001
10b00 00000 00001
10000 00000 00001
10000 00110 00001

12222 00000 00001
10002 00000 00001
00009 00001 00b01
10002 00000 00001
12222 00000 00001

10000 00110 00001
10000 00000 00001
10b00 00000 00001
10000 00000 00001
11111 11011 11111
a
