11111 11111 11111
10000 00A00 00001
10111 11111 11001
10100 00000 01001
10100 00000 01001

10100 h0h0h 00101
10100 00000 00101
1A100 h0h0h 00100
10100 00000 00101
10100 h0h0h 00101

10100 00000 00001
10100 00000 00001
10111 11111 00001
10000 00000 00001
11111 11011 11111
a
