11111 11111 11111
10000 00000 00001
10h00 00h00 00h01
10000 00000 00001
10000 00000 00001

10000 11111 00001
10000 10001 00001
0000A 10h01 A0000
10000 10001 00001
10000 1aaa1 00001

10000 00000 00001
10000 01010 00001
10000 00000 00001
10000 00000 00001
11111 11011 11111
a
