11111 11111 11111
10000 00100 000j1
10001 00100 00001
10001 00100 00001
10000 00100 00001

10011 0b100 00001
10000 00100 00001
00000 001b0 00000
10000 00111 11111
10011 000b0 00001

10000 10000 00001
10000 10001 11001
10000 00000 00001
10000 00000 00001
11111 11011 11111
a
