11111 11011 11111
10000 00000 00001
10000 00000 00001
10000 00100 00001
1000b 01110 b0001

10000 11111 00001
10010 00000 01001
00010 00b00 01000
10000 00b00 00001
10000 00000 00001

10000 00100 00001
10000 01110 00001
10000 11111 00001
10000 00000 00001
11111 11111 11111
a
