11111 11111 11111
10000 00000 00001
10000 00000 00001
10000 00b00 00001
10000 00000 00001

10000 11111 00001
10000 00000 00001
00000 00b00 00000
10000 00000 00001
10000 11111 00001

10000 00000 00001
10000 00b00 00001
10000 00000 00001
10000 00000 00001
11111 11111 11111
a
