11111 11111 11111
10000 00000 00001
10000 01000 00001
10000 00000 00001
10000 00000 00001

10000 00000 00001
10010 00000 00001
00000 b0000 00001
10000 00000 01001
10000 00b00 00001

10000 00000 00001
10000 00010 00001
10000 00000 00001
10000 00000 00001
11111 11011 11111
a
