11111 11011 11111
10000 00000 00001
10h00 00000 00h01
10000 00000 00001
10000 00A00 00001

10000 11111 11111
10000 00000 00001
10h00 00h00 A0000
10000 00000 00001
10000 00000 00001

10000 10000 00001
10000 10000 00001
10h00 10h00 00h01
10000 10000 00001
11111 11111 11111
a
