11111 11011 11111
10000 00000 00001
10000 00000 00001
1h100 00000 1h001
10100 00000 11001

10100 10000 00001
10100 10000 00001
1A100 10000 00000
10000 1h000 00001
1000A 11111 00001

10000 A0000 00001
10000 00000 00001
10000 00111 11001
1h000 00A00 0h001
11111 11111 11111
a
