11111 11011 11111
1A000 00000 000A1
10000 00000 00001
10000 10001 00001
1000h 10001 h0001

10011 10001 11001
10000 0h1h0 00001
00000 01110 00000
10000 0h1h0 00001
10011 10001 11001

1000h 10001 h0001
10000 10001 00001
10000 00000 00001
1A000 00000 000A1
11111 11011 11111
a
