11111 11011 11111
10000 00000 00001
10001 00000 10001
100h1 00000 1h001
10111 00a00 11101

10000 01110 00001
10000 00000 00001
00001 00h00 10000
10001 00000 10001
10001 00000 10001

10001 00000 10001
10001 00000 10001
10h01 00000 10h01
10h01 00h00 10h01
11111 11111 11111
a
