11111 11011 11111
1a000 00000 000a1
10000 00000 00001
1000A 00000 A0001
10000 11111 00001

10000 00100 00001
10000 00100 00001
00000 00100 00000
10000 00h00 00001
10000 00h00 00001

10000 11111 00001
10000 00h00 00001
10000 00100 00001
10000 00100 00001
11111 11111 11111
a
