11111 11111 11111
10001 00000 00001
10001 00000 00001
10001 00000 00001
10000 00000 00001

10000 00000 00001
10000 00h00 01001
00000 0hhh0 01000
10000 00h00 01001
10000 00000 00001

10000 00000 00001
10001 00000 00001
10001 00000 00001
10001 00000 00001
11111 11111 11111
a
