11111 11111 11111
10000 00A00 00001
10000 00011 10001
10000 00h00 00001
10001 11000 00001

10001 00001 10001
10001 00001 00001
00000 000a1 a0000
10001 00001 00001
10001 00001 10001

10001 11000 00001
10000 00h00 00001
10000 00011 10001
10000 00A00 00001
11111 11111 11111
a
