11111 11011 11111
10000 01000 000A1
10000 01000 00001
10001 01000 00001
10001 01000 00001

10001 0h100 00001
10001 001h0 00001
00001 00111 111h1
10001 00h00 00001
10001 00000 00001

1000h 00001 00001
11110 00001 h0001
10000 00001 00001
10000 00000 00001
11111 11111 11111
a
