11111 11011 11111
10000 00000 aAhh1
10000 00111 111h1
10000 00100 001A1
10000 00100 001a1

10000 00100 00101
10000 00100 00101
10111 11111 11100
10100 00100 00001
10100 00100 00001

1A100 00100 00001
10100 00100 00001
10111 11100 00001
1h00A 00000 00001
11111 11111 11111
a
