11111 11111 11111
10000 00000 000h1
10000 00A00 00001
10010 00000 00001
10h10 00000 00001

10110 11111 00001
10000 1h000 00001
00000 10000 00000
10000 10001 00001
10000 00001 00001

10000 00001 11001
10000 000h1 h0001
10000 00111 00001
1A000 00000 00001
11111 11111 11111
a
