11111 11111 11111
10000 00000 00001
10a00 10501 00a01
10000 10h01 00001
10000 01110 00001

10000 11111 00001
10000 10001 00001
0000h 10001 h0000
10000 10001 00001
10000 10001 00001

10100 00000 00101
101h0 00000 0h101
10111 11111 11101
10000 00000 00001
11111 11111 11111
a
