11111 11111 11111
10000 00000 000h1
1A111 00000 00A01
10100 00000 00001
10000 00000 00001

10000 00011 00001
10000 000h1 00001
00001 00001 00000
10001 00001 00001
11111 00001 00001

1000A 00001 00001
10000 00001 h0111
10000 00000 00001
1h000 00000 00001
11111 11111 11111
a
