11111 11111 11111
10000 00000 00001
10000 00000 00001
10000 00000 2b001
10000 22222 09001

10000 00000 02001
10000 00000 20001
00000 00b00 20b01
10000 00000 20001
10000 00000 02001

10000 22222 02001
10000 00000 20001
10000 00000 00001
10000 00000 00001
11111 11111 11111
a
